Steven	King	SYFBB@zhnsd.avc
Neena	Kochhar	QNLKJEHX@dogfp.ycw
Lex	De Haan	RKZCAQB@mpwtl.hqt
Alexander	Hunold	ISXEOQV@rfp.uvt
Bruce	Ernst	GLAYTA@udu.sqk
David	Austin	QMJBTKC@uyaajje.cvc
Valli	Pataballa	KFNKXBZF@lnldpox.win
Diana	Lorentz	XUHLBJYB@udu.sqk
Nancy	Greenberg	BTJYNUIH@sqn.fol
Daniel	Faviet	ZFROFAX@mlu.skn
John	Chen	NILAC@rpysj.qkg
Ismael	Sciarra	PTBHYSZQ@hqebh.pkd
Jose Manuel	Urman	FHMIEXC@tuhc.cin
Luis	Popp	KHUXG@bspozru.kvi
Den	Raphaely	XLGRVLLJ@mpwtl.hqt
Alexander	Khoo	LKXHN@cyswbsy.njm
Shelli	Baida	LRNGIO@jdeycng.eex
Sigal	Tobias	AJUNISJ@xjrnnhw.uwe
Guy	Himuro	LPLXNDF@bspozru.kvi
Karen	Colmenares	ZVMTYUSK@dogfp.ycw
Matthew	Weiss	KKHLHY@ndhvm.hyo
Adam	Fripp	VNYOKL@rpysj.qkg
Payam	Kaufling	VZAGNWOB@xjrnnhw.uwe
Shanta	Vollman	WNHGXBBY@yiv.bdy
Kevin	Mourgos	LRMZTZKD@ckgh.ncz
Julia	Nayer	GMKQYL@vgwpn.win
Irene	Mikkilineni	IFLTEHND@xjrnnhw.uwe
James	Landry	FZDTCIR@rfla.tmp
Steven	Markle	QUHKAZK@cem.vil
Laura	Bissot	LYHRNLH@ypb.ise
Mozhe	Atkinson	MTMEXVME@ihvey.lai
James	Marlow	VJSDEHE@luvcixu.kgb
TJ	Olson	BCIEWFU@hyj.wnz
Jason	Mallin	UDGPBHF@lnldpox.win
Michael	Rogers	IBGPNXW@uyaajje.cvc
Ki	Gee	ZGDM@clrq.obe
Hazel	Philtanker	TQRVAWNA@qrastcl.vuh
Renske	Ladwig	FMLRMLA@rhg.nfe
Stephen	Stiles	CNPSOSV@tjpstjq.wsi
John	Seo	FWRL@cfauqis.fuq
Joshua	Patel	CICFHW@hqebh.pkd
Trenna	Rajs	FCIYI@qslxwvd.bja
Curtis	Davies	ROGRGWV@mpwtl.hqt
Randall	Matos	WIXMRL@ulxdn.jmn
Peter	Vargas	JFLUITQ@ifgm.rko
John	Russell	BWQYRDR@qwgneaa.bxq
Karen	Partners	NOBJPEWW@qslxwvd.bja
Alberto	Errazuriz	CMRNZPTW@rpysj.qkg
Gerald	Cambrault	TJWBXNGS@ifgm.rko
Eleni	Zlotkey	PEYGSNFL@ihvey.lai
Peter	Tucker	DANPKHG@jdeycng.eex
David	Bernstein	OMLOYIBR@ndhvm.hyo
Peter	Hall	PUAQJ@hyj.wnz
Christopher	Olsen	AKQCNX@uyaajje.cvc
Nanette	Cambrault	LNSSSSVS@rfla.tmp
Oliver	Tuvault	DITFXKCF@dogfp.ycw
Janette	King	FSCFZ@cfauqis.fuq
Patrick	Sully	THEOSF@qslxwvd.bja
Allan	McEwen	WRCBXTW@bspozru.kvi
Lindsey	Smith	PWCTKB@luyjwzu.yof
Louise	Doran	WAKDSK@aalczkf.cgd
Sarath	Sewall	VQMNAMD@ghz.kny
Clara	Vishney	TESQSRSC@cyswbsy.njm
Danielle	Greene	KBMZHSS@hqebh.pkd
Mattea	Marvins	IGPKHWCQ@zhnsd.avc
David	Lee	ZMVY@vwkxogp.aht
Sundar	Ande	ZVKGT@ffb.ouh
Amit	Banda	CWGPUN@xjrnnhw.uwe
Lisa	Ozer	PAHZQ@zhnsd.avc
Harrison	Bloom	VGLVLI@psnwskr.eiw
Tayler	Fox	HDRU@rfp.uvt
William	Smith	SSUMDB@uyaajje.cvc
Elizabeth	Bates	WIMCFP@hzs.fgw
Sundita	Kumar	GGYLXU@rhg.nfe
Ellen	Abel	KEDCJ@rfla.tmp
Alyssa	Hutton	GIDJQBM@yiv.bdy
Jonathon	Taylor	VEFSEGX@ubstvjt.nwd
Jack	Livingston	MJKVGAVT@bspozru.kvi
Kimberely	Grant	AGYVOC@ypb.ise
Charles	Johnson	CSTYECIT@ghz.kny
Winston	Taylor	XAXAUNF@rfla.tmp
Jean	Fleaur	DANXIZY@ihvey.lai
Martha	Sullivan	SOWOYXBR@ckgh.ncz
Girard	Geoni	PRMYCC@clrq.obe
Nandita	Sarchand	RZYDITHN@jdeycng.eex
Alexis	Bull	GIKTN@ypb.ise
Julia	Dellinger	EVFYWRGI@luvcixu.kgb
Anthony	Cabrio	DKBUWSV@qslxwvd.bja
Kelly	Chung	TEHUKZ@aalczkf.cgd
Jennifer	Dilly	AFCOSX@rfla.tmp
Timothy	Gates	UOQTLI@tjpstjq.wsi
Randall	Perkins	LVQHQBHW@psnwskr.eiw
Sarah	Bell	ULZWB@ghz.kny
Britney	Everett	ABXUBNZH@jdeycng.eex
Samuel	McCain	HACQXBX@clrq.obe
Vance	Jones	CJMMCB@rhg.nfe
Alana	Walsh	HXWMLC@gxixsal.trx
Kevin	Feeney	UWDYYBN@sqn.fol
Donald	OConnell	IBVZCCPK@tjpstjq.wsi
Douglas	Grant	FHIKNQ@gxixsal.trx
Jennifer	Whalen	CUVESQZ@xjrnnhw.uwe
Michael	Hartstein	CLJWOMNL@aalczkf.cgd
Pat	Fay	AVIV@rhg.nfe
Susan	Mavris	CISFWBD@vwkxogp.aht
Hermann	Baer	LTXRS@cyswbsy.njm
Shelley	Higgins	LUGMGGBP@yiv.bdy
William	Gietz	CINFBB@ulxdn.jmn
